0 0 0 513 193 4 0 
1 0 0 256 96 0 1 3 
2 256 0 512 96 0 1 5 
3 0 96 256 192 0 2 3 4 
4 256 96 512 192 4 2 4 5 
41 256 96 512 192 0 0 
42 512 0 768 96 0 0 
43 256 192 512 288 0 0 
44 512 192 768 288 0 0 
