39 13 33
0 0 0 0 0 0 0 0 0 0 0 0 1 2 2 2 2 2 2 2 2 2 2 2 2 2 2 2 2 2 2 2 3 
0 0 0 0 0 0 0 0 0 0 0 0 1 2 2 2 2 2 2 2 2 2 2 2 2 2 2 2 2 2 2 2 3 
0 0 0 0 0 0 0 0 0 0 0 0 1 2 2 2 2 2 2 2 2 2 2 2 2 2 2 2 2 2 2 2 3 
0 0 0 4 5 6 0 0 0 0 0 0 1 2 2 2 2 2 2 2 2 2 2 2 2 2 2 2 2 2 2 2 3 
0 0 0 7 8 9 0 0 0 0 0 0 1 2 2 2 2 2 2 2 2 2 2 2 2 2 2 2 2 2 2 2 3 
0 0 0 0 0 0 0 0 0 0 0 0 1 2 2 2 2 2 10 11 2 2 2 12 13 14 2 2 2 2 2 2 3 
0 0 0 0 0 0 0 0 0 0 0 0 1 2 2 2 2 2 15 16 2 2 2 17 2 18 2 2 2 2 2 2 3 
0 0 0 0 0 0 0 0 0 0 0 0 1 2 2 2 2 2 15 10 11 2 2 19 20 21 2 2 2 2 2 2 3 
0 0 0 0 22 23 0 0 0 0 0 0 1 2 2 2 2 2 15 2 16 2 2 2 2 2 2 2 2 10 11 2 3 
0 0 0 0 24 25 23 0 26 27 0 0 1 2 2 2 2 2 15 2 10 11 2 2 2 2 2 2 2 15 16 2 3 
0 28 28 22 29 30 31 0 32 33 0 0 1 2 2 2 2 10 11 2 2 16 2 2 2 2 2 2 10 11 16 2 3 
34 35 35 35 35 35 35 35 35 35 35 35 35 35 35 35 35 35 35 35 35 35 35 35 35 35 35 35 35 35 35 36 3 
37 37 37 37 37 37 37 37 37 37 37 37 37 37 37 37 37 37 37 37 37 37 37 37 37 37 37 37 37 37 37 37 38 
