0 0 0 2817 434 4 0 
1 0 0 1408 217 0 0 
2 1408 0 2816 217 0 0 
3 0 217 1408 434 4 0 
31 0 217 704 434 4 2 5 6 
311 0 217 352 434 0 0 
312 352 0 704 217 0 0 
313 0 434 352 651 0 0 
314 352 434 704 651 0 0 
32 704 0 1408 217 0 0 
33 0 434 704 651 0 0 
34 704 434 1408 651 0 0 
4 1408 217 2816 434 4 0 
41 1408 217 2816 434 4 0 
411 1408 217 2816 434 4 0 
4111 1408 217 2816 434 4 0 
41111 1408 217 2816 434 4 0 
411111 1408 217 2816 434 0 4 7 8 11 12 
411112 2816 0 4224 217 0 0 
411113 1408 434 2816 651 0 0 
411114 2816 434 4224 651 0 0 
41112 2816 0 4224 217 0 0 
41113 1408 434 2816 651 0 0 
41114 2816 434 4224 651 0 0 
4112 2816 0 4224 217 0 0 
4113 1408 434 2816 651 0 0 
4114 2816 434 4224 651 0 0 
412 2816 0 4224 217 0 0 
413 1408 434 2816 651 0 0 
414 2816 434 4224 651 0 0 
42 2816 0 4224 217 0 0 
43 1408 434 2816 651 0 0 
44 2816 434 4224 651 0 0 
