0 0 0 2705 435 4 0 
1 0 0 1352 217 0 0 
2 1352 0 2704 217 0 1 3 
3 0 217 1352 434 0 1 0 
4 1352 217 2704 434 4 0 
41 1352 217 2704 434 4 0 
411 1352 217 2704 434 4 0 
4111 1352 217 2704 434 4 0 
41111 1352 217 2704 434 4 0 
411111 1352 217 2704 434 0 5 1 2 3 6 7 
411112 2704 0 4056 217 0 0 
411113 1352 434 2704 651 0 0 
411114 2704 434 4056 651 0 0 
41112 2704 0 4056 217 0 0 
41113 1352 434 2704 651 0 0 
41114 2704 434 4056 651 0 0 
4112 2704 0 4056 217 0 0 
4113 1352 434 2704 651 0 0 
4114 2704 434 4056 651 0 0 
412 2704 0 4056 217 0 0 
413 1352 434 2704 651 0 0 
414 2704 434 4056 651 0 0 
42 2704 0 4056 217 0 0 
43 1352 434 2704 651 0 0 
44 2704 434 4056 651 0 0 
